3 13 31
###############################
#p   ** *  *   4  *           #
# # # #*# # # # # # # # # # # #
#*     *  * *  *   * ** *6*   #
# # # # # #*# # # # # # #*# #3#
#*   *s*    *b* * x **        #
#5# # # # # # # # # # # # #*# #
#    *     *        s*   **   #
# ### # #*#*###*# # ### # #*# #
#     6  *   *2*    *   *     #
#*# # # # # # # # # # # # # #*#
# *    *  **    **f**    1*   #
###############################