2 13 31
###############################
#p   ** **  * b*              #
# # # #*# # # # # # # # # # # #
#*     ** * *  *   * ** 3 *   #
# # # # #1#*# # # # # # #*# # #
#*   *s*    *** * x **        #
# # # # # # # # # # # # # #*# #
#    *     *        f*   **   #
# #*# # #*#*#*#*# # # # # #*#3#
#        *   *2*    *   *     #
#*# # # # # # # # # # #*# # #*#
# * 4  * **    ** ***   1     #
###############################